###########
#A#     # #
# # ### # #
# # #   # #
#   # ### #
### #     #
#   ### # #
# ###   # #
#     #   #
# ### ###B#
###########
